NO  ../xpms/walls/north.xpm
SO ../xpms/walls/nami2.xpm
WE ../xpms/walls/west.xpm 
EA ../xpms/walls/east.xpm    






F 38,221,233

C 38,237,193

111111111111111111
100000000000000001
100N00000000001001
100000000000000001
100000000001000001
111111111111111111
