NO ./textures/north.xpm

SO ./textures/nami2.xpm

WE ./textures/west.xpm 

EA ./textures/east.xpm

F 38,111,0

C 255,255,255




111111111111111111
100000000000000001
100S00001000001001
100000001000000001
100000001001000001
111111111111111111
